40 30
13 13 13 13 13 13 13 13 13 13 13 10 3 0 0 0 0 0 0 0 0 0 0 0 0 0 0 0 0 0 0 0 13 13 13 0 0 0 0 0
10 10 10 10 10 10 10 10 10 10 10 3 3 3 0 0 0 0 0 0 0 0 0 0 18 16 19 0 0 0 0 0 3 3 3 0 0 0 0 0
10 10 10 10 10 10 10 10 10 10 10 3 3 3 0 0 0 0 0 0 0 0 0 18 16 16 16 19 0 0 0 0 3 3 3 0 0 0 0 0
13 13 13 8 8 8 8 10 8 8 8 10 2 0 0 0 0 0 15 0 9 9 18 21 16 16 16 21 19 9 9 0 0 3 0 0 0 0 0 0
10 10 10 8 8 8 8 10 5 7 6 10 2 0 0 0 0 0 0 0 9 9 16 16 16 16 16 16 16 9 9 0 0 2 0 0 0 18 19 0
10 10 10 8 8 8 8 10 15 7 10 10 2 0 0 0 0 0 0 0 9 9 16 21 16 16 16 21 16 9 9 0 0 2 0 0 18 16 17 19
13 13 13 10 7 7 10 10 15 12 10 10 2 0 0 0 0 0 0 0 0 0 16 16 16 16 16 16 16 0 0 0 0 2 0 0 16 17 17 17
10 10 5 11 4 7 11 6 15 15 10 13 2 13 0 0 0 0 0 0 0 14 16 16 16 22 16 16 16 14 0 0 13 2 13 0 20 16 16 21
10 10 10 10 7 4 10 10 15 15 10 10 2 0 0 0 0 0 0 0 15 14 14 14 14 14 14 14 14 14 0 0 0 2 0 0 16 22 16 16
10 10 10 10 7 7 10 15 15 10 10 10 2 0 0 0 0 0 0 0 0 1 14 14 14 14 14 14 14 14 3 0 0 2 0 0 0 0 0 0
13 10 10 10 7 7 10 15 15 10 10 10 2 0 0 0 13 0 0 0 0 0 0 0 0 0 0 0 0 0 0 0 0 2 0 0 0 0 0 0
2 2 2 2 2 2 2 2 2 2 2 2 2 2 2 2 2 2 2 2 2 2 0 0 0 0 0 0 0 0 0 0 0 2 0 0 0 0 0 0
13 0 0 0 0 0 0 0 0 0 0 0 13 0 0 0 0 0 0 0 0 2 0 0 0 9 9 9 0 0 0 0 0 2 0 0 0 0 0 0
0 0 0 0 0 0 0 15 0 0 0 0 0 0 0 18 16 19 0 0 0 2 0 0 0 9 15 9 0 0 0 0 0 2 0 0 0 0 0 0
0 15 0 0 0 0 0 0 0 0 0 9 9 0 0 16 20 16 0 0 0 2 0 0 0 0 9 0 0 0 0 0 0 2 0 0 8 8 8 0
3 0 0 8 8 8 8 8 0 0 0 9 9 0 18 17 16 16 19 0 0 2 0 0 0 0 0 0 0 0 0 0 0 2 0 0 7 7 7 0
0 0 0 8 8 8 8 8 0 0 0 0 0 0 17 21 16 21 16 0 0 2 0 0 0 8 8 8 0 0 0 0 0 2 13 13 4 7 4 0
0 0 0 8 8 8 8 8 0 0 0 3 0 0 16 16 22 16 16 14 1 2 0 0 0 8 8 8 0 0 0 0 0 2 13 13 7 7 7 3
0 0 0 0 0 7 0 0 0 0 0 0 0 0 14 14 14 14 14 14 0 2 0 0 0 0 7 0 0 0 0 0 0 2 0 14 12 22 12 14
0 0 0 0 0 7 0 0 0 0 0 0 0 0 0 0 0 0 0 0 0 2 0 0 0 5 7 6 0 0 0 0 0 2 0 14 14 14 14 14
0 0 0 0 0 4 0 0 0 0 0 0 0 0 0 0 0 0 0 0 0 2 0 0 0 10 4 10 0 0 0 0 0 2 0 0 0 0 0 0
0 0 0 0 0 7 0 0 0 0 0 0 0 0 0 13 0 0 0 0 0 2 0 0 0 10 12 10 0 3 0 0 0 2 0 0 0 0 0 0
0 0 0 0 10 7 10 0 0 0 0 0 0 2 2 2 2 2 2 2 2 2 2 2 2 2 2 2 2 2 2 2 2 23 0 0 0 0 0 0
0 0 0 0 10 12 10 0 0 0 0 0 0 2 0 13 0 0 0 0 0 0 0 0 0 0 0 0 0 0 0 0 0 2 0 0 0 0 0 0
23 2 2 2 2 2 2 2 2 2 2 2 2 2 0 0 0 0 0 0 0 18 16 19 0 0 0 0 0 0 0 0 0 2 0 0 0 0 0 0
0 0 0 0 0 0 0 0 0 0 0 0 0 0 0 0 0 0 0 0 18 16 16 16 19 0 0 0 0 0 0 0 13 2 13 0 0 0 0 0
0 0 15 0 0 0 0 0 0 0 0 0 0 0 0 0 0 0 0 0 21 16 16 16 21 0 0 0 0 0 0 0 0 2 0 0 0 0 0 0
0 0 3 0 0 0 0 15 0 0 0 0 0 0 0 0 0 0 0 14 16 16 16 16 16 14 0 0 0 0 0 0 0 2 0 0 0 0 0 0
0 0 0 0 0 0 0 0 3 0 0 0 13 13 13 13 13 13 13 14 16 16 22 16 16 14 1 13 13 13 13 13 13 2 0 0 0 0 0 0
24 24 24 24 24 24 24 24 24 24 24 24 24 24 24 24 24 24 24 24 24 24 24 24 24 24 24 24 24 24 24 24 24 24 24 24 24 24 24 24