40 30
0 0 0 0 0 0 0 0 0 8 0 0 0 0 0 0 8 0 0 0 0 0 0 0 2 0 0 0 0 0 0 0 0 0 0 0 0 0 0 0
0 0 0 0 0 0 0 0 8 8 8 0 0 0 0 8 8 8 0 0 0 0 0 0 2 0 0 18 19 0 0 0 0 0 0 0 0 0 0 0
2 2 2 2 2 2 0 0 0 7 6 0 0 0 0 8 8 8 0 0 0 0 0 0 2 0 18 17 17 19 0 0 0 0 0 0 0 0 0 0
0 0 0 0 0 2 0 0 5 7 0 0 0 0 0 0 4 0 0 0 0 0 0 0 2 0 20 16 16 20 0 0 0 0 0 0 0 0 0 0
0 0 8 0 0 2 0 0 0 0 0 0 0 0 0 0 12 0 0 0 9 9 9 0 2 0 16 22 16 16 0 0 0 0 0 0 0 0 0 0
0 8 8 8 0 2 0 0 0 0 0 0 0 0 0 0 0 0 0 0 9 9 9 0 2 0 0 0 0 0 0 0 0 0 0 0 0 0 0 0
0 0 4 6 0 2 0 0 0 0 0 0 0 0 0 0 0 0 0 0 0 0 0 2 2 0 0 0 0 0 0 0 0 0 0 0 0 0 0 0
0 5 7 0 0 2 0 0 0 0 0 0 0 0 0 0 0 8 8 8 0 2 2 2 0 0 0 0 0 0 8 8 8 0 0 0 0 0 0 0
0 0 0 0 0 2 0 0 0 0 0 0 0 0 0 0 0 8 8 8 0 2 0 0 8 8 8 0 0 0 8 8 8 0 0 0 0 0 0 0
0 0 0 0 0 2 0 0 0 0 0 0 0 0 0 0 0 0 4 0 0 2 0 8 8 8 8 8 0 0 0 4 0 0 0 0 0 0 0 0
0 0 0 0 0 2 0 0 0 0 0 0 0 8 8 0 0 13 12 13 0 2 0 8 8 8 8 8 0 0 0 12 0 0 0 0 0 0 0 0
0 0 0 0 0 2 0 0 0 0 0 0 8 8 8 8 0 13 13 13 0 2 0 0 0 7 0 0 0 0 0 0 0 0 0 0 0 0 0 0
0 0 0 0 0 2 0 0 0 0 0 0 8 8 8 8 0 0 0 0 0 2 0 0 0 4 11 6 0 0 0 0 0 0 0 0 0 0 0 0
0 0 0 0 0 2 0 0 0 0 0 0 0 4 4 0 0 0 0 0 0 2 2 2 0 7 0 0 0 0 0 0 0 0 0 0 0 0 0 0
0 0 0 0 0 2 0 0 0 0 0 0 0 12 12 0 0 8 8 8 0 0 0 2 0 12 0 0 0 8 8 8 0 0 0 0 0 0 0 0
0 0 0 0 0 2 2 2 2 2 2 2 2 0 0 0 0 8 8 8 0 0 0 2 0 0 0 0 0 8 8 8 0 0 0 0 0 0 0 0
0 0 0 0 0 0 0 0 0 0 0 0 2 2 2 2 2 0 7 0 0 13 13 2 0 0 0 0 0 7 4 7 0 0 0 0 0 0 0 0
0 0 0 0 0 0 0 0 0 0 0 8 8 8 0 0 2 0 4 0 0 13 13 2 0 0 0 0 0 7 4 7 0 0 0 0 0 0 0 0
0 0 0 0 0 0 0 0 0 0 0 8 8 8 0 0 2 0 12 0 0 13 13 2 0 0 0 0 0 7 7 7 0 0 0 0 0 0 0 0
0 0 0 0 0 0 0 0 0 0 0 0 4 0 0 0 2 2 2 0 0 0 0 2 0 0 0 0 0 12 22 12 0 0 0 0 0 0 0 0
0 0 0 0 9 9 0 0 0 0 0 0 12 0 0 0 0 0 2 0 0 0 0 2 2 2 2 2 2 2 2 2 2 2 2 2 2 2 2 2
0 0 0 0 9 9 0 0 0 0 0 0 0 0 0 0 0 0 2 2 2 2 2 2 0 0 0 0 0 0 0 0 0 0 0 0 0 0 0 0
0 0 0 0 0 0 0 0 0 0 0 0 0 0 18 17 19 0 0 0 0 2 0 0 0 0 0 0 0 0 0 0 0 0 0 18 16 19 0 0
0 0 0 0 0 0 0 0 0 0 0 0 0 18 17 17 17 19 0 0 0 2 8 8 8 0 0 0 0 0 0 0 0 0 0 16 8 16 0 0
0 24 0 0 0 0 0 0 0 0 0 0 0 20 16 16 16 20 0 0 0 2 8 8 8 0 0 10 10 10 0 0 0 0 0 16 8 16 0 0
0 0 0 0 0 0 0 0 0 0 0 0 0 16 16 16 16 16 0 0 0 2 0 4 0 0 0 10 10 10 0 0 0 0 0 16 8 16 0 0
0 0 0 0 0 0 0 0 0 0 0 0 0 16 16 22 16 16 0 0 0 2 0 12 0 0 0 0 0 0 0 0 0 0 0 16 22 16 0 0
0 0 0 0 0 0 0 0 0 0 0 0 0 0 0 0 0 0 2 2 2 2 0 0 0 0 0 0 0 0 0 0 0 0 0 0 0 0 0 0
0 0 0 0 0 0 0 0 0 0 0 0 0 0 0 0 0 0 0 0 0 0 0 0 0 0 0 0 0 0 0 0 0 0 0 0 0 0 0 0
23 23 23 23 23 23 23 23 23 23 23 23 23 23 23 23 23 23 23 23 23 23 23 23 23 23 23 23 23 23 23 23 23 23 23 23 23 23 23 23