40 30
3 3 3 3 3 3 3 3 3 3 3 3 3 3 3 3 3 3 3 3 3 3 3 3 3 3 3 3 3 3 3 3 3 3 3 3 3 3 3 3
16 16 16 16 16 16 16 16 16 16 12 16 16 16 16 16 16 16 16 16 16 16 16 16 16 16 12 16 16 16 16 16 16 16 16 16 16 16 16 16
0 0 0 0 0 0 16 13 2 2 2 2 2 2 2 2 2 2 2 2 2 2 2 2 2 2 2 2 2 2 13 16 0 0 0 0 0 0 0 6
0 0 0 0 0 0 16 2 2 2 2 2 2 2 2 2 2 2 2 2 2 2 2 2 2 2 2 2 2 2 2 16 0 0 0 0 0 0 0 6
0 0 0 0 0 0 16 2 2 2 2 2 2 2 2 2 2 2 2 2 2 2 2 2 2 2 2 2 2 2 2 16 0 0 0 0 0 0 0 6
0 0 0 0 0 0 16 2 2 2 2 2 2 2 2 2 2 2 2 2 2 2 2 2 2 2 2 2 2 2 2 16 0 0 0 0 0 0 0 6
0 0 0 0 0 0 16 2 2 2 2 2 2 2 2 2 2 2 2 2 2 2 2 2 2 2 2 2 2 2 2 16 0 0 0 0 0 0 0 6
0 0 0 0 0 0 16 2 2 2 2 2 2 2 2 11 11 11 11 11 11 11 11 2 2 2 2 2 2 2 2 16 0 0 0 0 0 0 0 6
0 0 0 0 0 0 16 2 2 2 2 2 2 2 2 11 11 11 11 11 11 11 11 2 2 2 2 2 2 2 2 16 0 0 0 0 0 0 0 6
0 0 0 0 0 0 5 2 2 2 2 2 2 2 2 11 11 11 11 11 11 11 11 2 2 2 2 2 2 2 2 5 0 0 0 0 0 0 0 6
0 0 0 0 0 0 16 2 2 2 2 2 2 2 2 2 2 2 2 2 2 2 2 2 2 2 2 2 2 2 2 16 0 0 0 0 0 0 0 6
0 0 0 0 0 0 16 2 2 2 2 2 2 2 2 2 2 2 2 2 2 2 2 2 2 2 2 2 2 2 2 16 0 0 0 0 0 0 0 6
0 0 0 0 0 0 16 2 2 2 2 2 2 2 2 2 2 2 2 2 2 2 2 2 2 2 2 2 2 2 2 16 0 0 0 0 0 0 0 6
0 0 0 0 0 0 16 2 2 2 2 2 2 2 2 2 2 2 2 2 2 2 2 2 2 2 2 2 2 2 2 16 0 0 0 0 0 0 0 6
0 0 0 0 0 0 16 13 2 2 2 2 2 2 2 2 2 2 2 4 2 2 4 2 2 2 2 2 2 2 13 16 0 0 0 0 0 0 0 6
0 0 0 0 0 0 16 16 16 16 16 5 16 16 16 16 16 16 16 16 2 2 16 16 16 16 5 16 16 16 16 16 0 0 0 0 0 0 0 6
0 0 0 0 0 0 16 13 2 2 2 2 2 2 2 2 2 2 2 4 2 2 4 2 2 2 2 2 2 2 13 16 0 0 0 0 0 0 0 6
0 0 0 0 0 0 16 2 2 2 2 2 2 2 2 2 2 2 2 2 2 2 2 2 2 2 2 2 2 2 2 16 14 14 0 0 0 0 0 6
0 0 0 0 0 0 16 2 2 2 2 2 2 2 2 2 2 2 2 2 2 2 2 2 2 2 2 2 2 2 2 5 14 14 0 0 0 0 0 6
0 0 0 0 14 14 5 2 2 2 2 2 2 2 2 2 2 2 2 2 2 2 2 2 2 2 2 2 2 2 2 16 14 14 0 0 0 0 0 6
0 0 0 0 14 14 16 2 2 2 2 2 2 2 2 2 2 2 2 2 2 2 2 2 2 2 2 2 2 2 4 16 0 0 0 0 0 0 0 6
0 0 0 0 14 14 16 2 2 2 2 2 2 2 2 2 4 11 11 11 13 11 11 11 4 2 2 2 2 2 2 2 0 0 0 0 0 0 0 6
0 0 0 0 0 0 16 4 2 2 2 2 2 2 2 2 2 11 11 11 11 11 11 11 2 2 2 2 2 2 2 2 0 1 0 0 0 0 0 6
0 0 0 0 0 0 2 2 2 2 2 2 2 2 2 2 2 11 11 11 11 11 11 11 2 2 2 2 2 2 4 16 0 0 0 0 0 0 0 6
1 0 0 0 0 0 2 2 2 2 2 2 2 2 2 2 4 11 11 11 13 11 11 11 4 2 2 2 2 2 2 16 0 0 0 0 0 0 0 6
0 0 0 0 14 14 16 4 2 2 2 2 2 2 2 2 2 2 2 2 2 2 2 2 2 2 2 2 2 2 2 16 14 14 0 0 0 0 0 6
0 0 0 0 14 14 16 2 2 2 2 2 2 2 2 2 2 2 2 2 2 2 2 2 2 2 2 2 2 2 2 16 14 14 0 0 0 0 0 6
0 0 0 0 14 14 16 13 2 2 2 2 2 2 2 2 2 2 2 2 2 2 2 2 2 2 2 2 2 2 13 16 14 14 0 0 0 0 0 6
16 16 16 16 16 16 16 16 16 16 16 16 16 16 16 16 16 16 16 16 16 16 16 16 16 16 16 16 16 16 16 16 16 16 16 16 16 16 16 16
17 17 17 17 17 17 17 17 17 17 17 17 17 17 17 17 17 17 17 17 17 17 17 17 17 17 17 17 17 17 17 17 17 17 17 17 17 17 17 17